1111111111111111111111111111111
10000000000000000000000000001C1
1PE0000000000011000000000000111
111000000000C111111110000000001
1111111111111111111111111111111