1111111111111111111111
1000000T00000C000000E1
1000000100000C00000001
1000000100000C00000001
1000000100000C000P0001
1000000100000000000001
1111111111111111111111