11111111
10000PC1
10000E11
100E0001
11111111