11111111111111111111111111111111111
1000000000C0000000000E0000000000001
10000000000000000000000000000000001
10000000000000000000000000000000001
1000000000C000000000000000000000001
1000000000000000000000000000C000001
111111C1000000000000000000000000001
10000000000000000000000000000000001
10000000000010000000000000000000001
100000000000100000000P0000000000001
10000000000010000000000000000000001
100000000000100000000000000000000P1
11111111111111111111111111111111111