111111111111111111111111
9000P0100000000100000001
100100000000000100000001
1001111000000001000000C1
100010100000000000000011
100100000000000011111111
10000000000000CC10000001
100000000000000000000001
100000000110000000000C11
100000000000000000000001
10000000C0100C0000000001
100000000010000000000001
100E000000100000000000C1
111111111111111111111111
