1111111111111111111111111111
1000000000000000000010000001
1000000000000000000010000001
1000000000000000000010000001
1000000000000000000000000001
10000000000C0000000000000001
10000000000C0000000000000001
10000000000C00000000E0000001
1000000000000000000000000001
1000000000000000100000000001
1000000000000000100000000001
1000000000000000100000000001
1111111111111111111111111111