1111111111111111111111111111111111
110000000000000000000100000P000001
1000000000000000000001000000000001
1111111111111111111011000000000001
1E00000000000000000001000000000001
1110000000000000000001000000000001
1001000000000000000000000000000001
1001000000000000000000000000000001
1001000000000000000000000001100001
1001001111111111111111000001100001
1001000000000000000000000001100001
1000000000000000000000000001100001
1000000000000000000000000001100001
1111111111111111111111111111111111
