111111111111
101100000001
10110000C001
10000000C001
100000000001
10000PC11111
111111111111
