
1111111111
100C000001
10000C0001
100E000001
1000000P01
1111111111