1111111111111111111111111111111111111111111
100000000000000000000010000000E000000000111
1000000000000000000000100000000000000000111

1000000000000000000000100000000000000000111
100000000000000C00000010000000P000000000111
1000000000000000000000000000000000000000111
1000000000000000000000000000000000000000111
100000000000000C000000000000000000000000111
1111111111111111111111111111111111111111111