1111111
1P100C1
11000E1
1111111
