111111111111111111111111111111111111111111
100000000000000P00000000000001000000000011
100000000000000100000000000001000000000011
100000000000000100000000000001000000000011
100000000000000100000000000000000C00000011
111111111111111111111111111111111111111111
100000000000000E00000000000000000000000011
100000000000000000000000000000000000000011
100000000000000000000000000000000000000111
100000000000000000000000000000000000000011
111111111111111111111111111111111111111111