11111111111111111111111111111111111
1000000000000000000000000000000001
11111P00000000000000CE00000000001
111111111111111111111111111111111