111111111111111111
100000000000C001C1
10P0000000000001C1
1000000000000001E1
100000000000000001
111111111111111111